11
11
11111111111
12001000001
11101011101
10001000101
10111010111
10001010001
11101111101
13100000101
10111110101
10000000001
11111111111
