11
11
11111111111
12100000001
10011010101
10000010101
11101010001
10001010101
10111100101
10000000001
11110111101
13000000001
11111111111
