11
11
11111111111
12000000101
10101010101
10100000001
10101011101
10001000001
11111010111
10001000001
13101110101
10000000001
11111111111
